%%%%%%%%%%%%%%%%%%
%.              .%
%                %
%                %
%       P        %
%                %
%       .        %
%.              .%
%%%%%%%%%%%%%%%%%%